11111111111
10000010001
10001110C01
10011C00001
10P11000E01
11111111111
