11111111111
10000000001
1P001110C01
10011C00001
10011000E01
11111111011
